################
################
########..######
######.....#####
#####.......####
####.......#####
####...@...#####
####.......#####
#####.......####
######.....#####
########..######
################
