################
################
########..######
#######....#####
######......####
#####......#####
#####...@...####
#####......#####
######......####
#######....#####
########..######
################
