################
################
######..########
#####.....######
####.......#####
###.......######
###...@...######
###.......######
####.......#####
#####.....######
######..########
################
